██████████████████████████████████████████████████████████████████
██                                         ██                   ██
██                                         ██                   ██
██                                         ██                   ██
██                                         ██                   ██
██                                         ██                   ██
██                                         ██                   ██
██                                         ██                   ██
██                                         ██                   ██
██                                         ██                   ██
██                                         ██                   ██
██                                         ██                   ██
██                                         ██                   ██
██                                         ██                   ██
██                                         ██                   ██
██                                         ██                   ██
█████████████████████████████████████████████                   ██
██                                         ██                   ██
██                                         ██                   ██
██                                         ██                   ██
██                                         ██                   ██
██                                         ██                   ██
██████████████████████████████████████████████████████████████████