██████████████████████████████████████████████████████████████████████████████
██                                                ██                        ██
██                                                ██                        ██
██                                                ██                        ██
██                                                ██                        ██
██                                                ██                        ██
██                                                ██                        ██
██                                                ██                        ██
██                                                ██                        ██
██                                                ██                        ██
██                                                ██                        ██
██                                                ██                        ██
██                                                ██                        ██
██                                                ██                        ██
██                                                ██                        ██
██                                                ██                        ██
██                                                ██                        ██
██                                                ██                        ██
██                                                ██                        ██
████████████████████████████████████████████████████                        ██
██                                                ██                        ██
██                                                ██                        ██
██                                                ██                        ██
██                                                ██                        ██
██                                                ██                        ██
██                                                ██                        ██
██                                                ██                        ██
██████████████████████████████████████████████████████████████████████████████